1111111111
1E01000001
110C011101
1111111101
1111100001
1111101111
1000100001
1010111001
1P10000001
1111111111
