111111111111111111111111111111111111111111111111111111111111
1E0000000000000000000000000000000000000000000000000000000001
100000000000000000000000000000000010000000000000000000000001
101111111111111110011111111111111111111111111111111111111001
101000000000000010010000000000000000000000000000000001001001
101011110011111110010011111111111111111111111111111001001001
101000010010000010010010010000000000000000000000000001001001
101111110010010010010010010011111111111111111111111111001001
1000000100100100100100C001001000000C000000000000000000001001
101111110010011110011111110010011111111111111111111111111001
1000C0000010000000000000010010000000000000000000000000000001
101111110011111111111110010011111111111111111111111111111111
101000010010000000000010010000000000000000000000000000000001
101010010010011111110010010011111111111111001111101111111111
101010010010010000010010010010010000000011001000000000000001
101010010010011110010010010010010011110011001111001001111111
10101001001000000001001P010010010010010011001001001001000001
101010010011111111110010010010010010010011001001001001001111
1010100100000000000000100100000100100100110010010010010010C1
111011111111111111111110011111110010010011001001001001001001
101000000000000000000000000000000010010011001001001001001001
101111111111111111111111111111110010010011001001001001001001
1010000000000000C0000000010000010010110111011011011011011011
101010000000000000000010010010010010010011000001001001001001
101011111111111111110010010010010010010011111111001001001001
101000000000000000000010000010010010000000000000001000001001
100000000000000000000010010010010010010000000000001001001001
101111111111111110010010010010010010010011111111001001000001
1010C0000000000000010010010010000010010011000001001001001001
111111111111111111111111111111111111111111111111111111111111