11111111111111111111111111111
1E000000000000000000000000001
10000000000000000000000000001
10111111111111111001111011111
101000000000000010010100000C1
10101111001111111001001111111
10100001001000001001001000001
10111111001001001001001001001
1000000100100100100100C001001
10111111001001111001111111001
1000C00000100P000000000001001
10111111001111111111111000001
101000010010C0000000001001001
10101001001001111111000001001
11111111111111111111111111111